version,1.0
name,The first level!
size,10,10

player:
end

entities:
end

data:
end

tiles:
16,16,16,16,16,16,16,16,16,16
16, 0, 0, 0, 0, 0, 0, 0, 0,16
16, 0, 1, 0, 3, 2, 4, 0, 1,16
16, 0, 2, 0, 0, 1, 0, 3, 0,16
16, 2, 0, 1, 4,19, 0, 3, 0,16
16, 0, 0, 2, 0,19,19, 0, 0,16
16, 1, 3, 0,19,19,19, 0, 0,16
16, 0, 4, 3,19,19, 0, 4, 2,16
16, 2, 1, 0, 0, 0, 2, 0, 0,16
16,16,16,16,16,16,16,16,16,16
end